NO assets/textures/42-cluster.xpm
SO assets/textures/42-gallery.xpm
WE assets/textures/42-window.xpm
EA assets/textures/42-42sp.xpm

F 218,218,218
C 28,13,120

11111111111
1S000000001
10000000001
11111011111
10000000001
10000000001
10000000001
10000000001
10000000001
10011111001
10011111001
10011111001
10011111001
10011111001
10011111001
11011111101
10000000001
10000000001
10000000001
10000000001
10000000001
10000000001
10000000001
10000000001
11011111111
10000000001
10000000001
11111111111