WE assets/texture/bendy.xpm
NO assets/texture/bendy.xpm
EA assets/texture/bendy.xpm
SO assets/texture/bendy.xpm

C 46,7,7
F 36,6,6


1111111111111111111111
1000001100000001011001
100N0011000000010110N1
1000001111100001011001
1000000000000001011001
1011111111110001011001
1000000000000001011001
1000000110000011011001
1001001111000001011001
1001000000000000000001
1111111111111111111111