NO assets/texture/brick_ani.xpm
SO assets/texture/brick_ani.xpm
WE assets/texture/brick_ani.xpm
EA assets/texture/brick_ani.xpm

C 109,101,101
F 79,71,71


           1111111111111111111111
           1000001100000001011001
1111111111110000011000000010110N1
100000111110000101100111111111111
1000000000000001011001
1011111111110001011001
1000000000000001011001
1000000110000011011001
1001001111000001011001
1001000000000000000001
1111111111111111111111