NO assets/texture/north.xpm
SO assets/texture/south.xpm
WE assets/texture/east.xpm
EA assets/texture/west.xpm

S 46,7,7
F 36,6,6

11111111111111111
11100000000000111
11001111111001111
11011000001101111
11011000001101111
11011000001101111
11001111111001111
11100000000000111
111111S0111111111
11100000000000111
11001111111001111
11001000001001111
11011000001101111
11011000001101111
11001111111001111
11100000000000111
11111111111111111
