NO texture/north.xpm
SO texture/south.xpm
WE texture/east.xpm
EA texture/west.xpm



S 46,7,7
F 36,6,6














111111111111111111111111111111111111111111111111111111111111111111
100000000000000000000000000000000000000000000000000000000000000001
101111111111111111111111111111111111111111111111111111111111110101
101000000000000000000000000000000000000000000000000000000000010101
101011111111111111111111111111111111111111111111111111111110010101
101010000000000000000000000000000000000000000000000000000010010101
10101011111111111111111111111111111111111111111111111111101001N101
101010100000000000000000000000000000000000000000000000001010010101
101010101111111111111111111111111111111111111111111111101010010101
101010101000000000000000000000000000000000000000000001001010010101
101010101011111111111111111111111111111111111111111101001010010101
101010101010000000000000000000000000000000000000000100101010010101
101010101010111111111111111111111111111111111111111100101010010101
101010101010100000000000000000000000000000000000001000101010010101
101010101010101111111111111111111111111111111111101000101010010101
101010101010101000000000000000000000000000000000001000101010010101
101010101010101011111111111111111111111111111111101000101010010101
101010101010101000000000000000000000000000000000001000101010010101
101010101010101111111111111111111111111111111111111000101010010101
100000000000000000000000000000000000000000000000000000000000000001
111111111111111111111111111111111111111111111111111111111111111111
