NO texture/north.xpm
SO texture/south.xpm
WE texture/east.xpm
EA texture/west.xpm

F 36,6,6
C 5,5,71

1111111111111111111111
10000000000000010110Z1
1000000000000001011001
1000000000000001011001
1000000000000001011001
1000000000000001011001
1000000000000001011001
1000000000000001011001
1000000000000001011001
1000000000000000000001
1111111111111111111111