NO assets/texture/land.xpm
SO assets/texture/land.xpm
WE assets/texture/brdr.xpm
EA assets/texture/brdr.xpm

C 150,120,20
F 100,100,100

1111111111111111111111
1000001100000001011001
1111111111110000011001
1000001111100001011001
1000000000000001011001
1011111111110001011001
1000E00000000001011001
1000000110000011011001
1001001111000001011001
1001000000000000000001
1111111111111111111111