NO ./assets/texture/shrek1.xpm
SO ./assets/texture/shrek2.xpm
WE ./assets/texture/shrek3.xpm
EA ./assets/texture/shrek4.xpm

F 101, 67, 33
C 135, 206, 250

11111111111111111111111111111
10001110000000000000111000001
10010010000000000000100100001
10111111111111111111111111001
10000000000000000000000000001
10000000000000000000000000001
10011000000000000001100000001
10000000000N00000000000000001
10000000000000000000000000001
10000011111111111111000000001
10000000000000000000000000001
11111111111111111111111111111