NO ./assets/texture/shrek1.xpm
SO ./assets/texture/shrek2.xpm
WE ./assets/texture/shrek3.xpm
EA ./assets/texture/shrek4.xpm

F 101, 67, 33
C 135, 206, 250

1111
1N01
1001
1111