NO assets/texture/bendypink.xpm
SO assets/texture/bendygreen.xpm
WE assets/texture/bendywhick.xpm
EA assets/texture/bendy.xpm

C 224,227,68
F 255,227,43

1111111111111111111
1001000000100000001
1011011110101111101
1010000010100000101
1010111010111110101
1000100010000010001
1111101111111011111
10000010N0001010001
1011111011111011101
1010000010000010001
1010111110111110101
1010000000100000101
1011111111111111101
1000000000000000001
1111111111111111111
